30, 30, 30, 30, 30, 30, 30, 30, 30, 30, 30, 30, 30, 30, 30, 30, 
30, 30, 30, 30, 30, 30, 30, 30, 30, 30, 30, 30, 30, 30, 30, 30, 
30, 30, 30, 30, 30, 30, 30, 30,
30, 0, 0, 0, 0, 0, 0, 0, 0, 0, 0, 0, 0, 0, 0, 0, 
40, 30, 10, 10, 10, 0, 0, 0, 0, 0, 0, 0, 0, 0, 0, 0, 
0, 0, 0, 0, 0, 0, 0, 30,
30, 0, 0, 0, 0, 0, 0, 0, 0, 0, 0, 0, 0, 0, 0, 0, 
30, 30, 30, 30, 30, 30, 0, 0, 0, 0, 0, 0, 0, 0, 0, 0, 
0, 0, 0, 0, 0, 0, 0, 30,
30, 0, 0, 0, 0, 0, 0, 0, 0, 0, 0, 0, 0, 0, 0, 0, 
0, 0, 0, 0, 0, 0, 0, 0, 0, 0, 0, 0, 0, 0, 0, 0, 
0, 0, 0, 0, 0, 0, 0, 30,
30, 0, 0, 0, 0, 0, 0, 0, 0, 0, 0, 0, 0, 0, 0, 0, 
0, 0, 0, 0, 0, 0, 0, 28, 28, 28, 28, 0, 0, 0, 0, 0, 
0, 0, 0, 0, 0, 0, 0, 30,
30, 0, 0, 0, 0, 0, 0, 0, 28, 28, 28, 28, 28, 0, 0, 0, 
0, 0, 0, 0, 0, 0, 0, 0, 0, 0, 0, 0, 0, 28, 28, 28, 
28, 0, 0, 0, 0, 0, 0, 30,
30, 0, 0, 0, 0, 0, 0, 0, 0, 0, 0, 0, 0, 0, 0, 0, 
0, 0, 0, 0, 0, 0, 0, 0, 0, 0, 0, 0, 0, 0, 0, 0, 
0, 0, 0, 28, 28, 28, 0, 30,
30, 0, 0, 39, 0, 0, 39, 0, 0, 0, 71, 39, 0, 0, 0, 0, 
39, 0, 0, 0, 0, 71, 71, 0, 0, 39, 0, 0, 0, 39, 0, 71, 
0, 0, 0, 39, 0, 0, 0, 30,
30, 30, 30, 30, 30, 30, 30, 30, 30, 30, 30, 30, 30, 30, 30, 30, 
30, 30, 30, 30, 30, 0, 0, 30, 30, 30, 30, 30, 30, 30, 30, 30, 
30, 30, 30, 30, 30, 30, 30, 30,
30, 0, 0, 0, 0, 0, 0, 0, 0, 0, 0, 0, 0, 0, 0, 0, 
0, 0, 0, 0, 30, 30, 0, 30, 0, 0, 0, 0, 0, 0, 0, 0, 
0, 0, 0, 0, 0, 0, 30, 30,
30, 0, 0, 0, 0, 0, 0, 0, 0, 0, 0, 0, 0, 0, 0, 0, 
0, 0, 0, 0, 0, 0, 0, 30, 0, 10, 0, 0, 0, 0, 39, 0, 
0, 0, 71, 0, 0, 0, 30, 30,
30, 39, 0, 0, 0, 0, 0, 71, 0, 0, 0, 0, 0, 0, 0, 0, 
0, 0, 0, 0, 0, 30, 30, 30, 30, 30, 30, 30, 30, 30, 30, 30, 
30, 30, 0, 0, 0, 30, 0, 30,
30, 30, 30, 30, 30, 30, 30, 0, 0, 30, 0, 0, 0, 0, 0, 0, 
0, 0, 0, 0, 30, 30, 30, 0, 0, 0, 0, 0, 0, 0, 0, 0, 
0, 0, 0, 0, 30, 0, 0, 30,
30, 0, 0, 0, 0, 0, 0, 0, 0, 0, 30, 0, 0, 0, 0, 0, 
0, 0, 0, 0, 0, 0, 30, 30, 30, 0, 0, 0, 0, 0, 0, 0, 
0, 0, 0, 30, 0, 0, 0, 30,
30, 0, 0, 0, 0, 0, 0, 0, 28, 0, 0, 30, 0, 0, 0, 0, 
0, 30, 30, 0, 0, 0, 30, 0, 0, 30, 0, 0, 0, 30, 0, 0, 
0, 0, 30, 0, 0, 0, 0, 30,
30, 0, 0, 0, 0, 0, 0, 28, 0, 0, 0, 0, 30, 0, 0, 0, 
0, 0, 0, 0, 0, 0, 30, 0, 0, 0, 30, 0, 0, 0, 30, 0, 
0, 0, 0, 0, 0, 0, 0, 30,
30, 29, 0, 0, 0, 0, 0, 0, 0, 0, 0, 0, 0, 30, 0, 0, 
0, 0, 0, 0, 0, 0, 30, 0, 0, 0, 0, 30, 0, 0, 0, 30, 
0, 0, 0, 0, 0, 0, 0, 30,
30, 30, 30, 30, 30, 30, 30, 30, 30, 30, 30, 30, 30, 30, 30, 0, 
0, 0, 30, 30, 30, 30, 30, 0, 0, 0, 0, 0, 30, 0, 0, 0, 
30, 0, 0, 0, 0, 0, 0, 30,
30, 10, 0, 0, 0, 0, 0, 0, 0, 0, 0, 0, 0, 0, 0, 0, 
71, 0, 0, 0, 0, 0, 0, 0, 0, 39, 0, 0, 0, 0, 0, 0, 
0, 30, 0, 0, 0, 0, 0, 30,
30, 30, 30, 30, 30, 30, 30, 30, 30, 30, 30, 30, 30, 30, 30, 30, 
30, 30, 30, 30, 30, 30, 30, 30, 30, 30, 30, 30, 30, 30, 30, 30, 
30, 30, 30, 30, 0, 0, 0, 30,
30, 0, 0, 0, 0, 0, 0, 0, 0, 0, 0, 0, 0, 0, 0, 0, 
0, 0, 0, 0, 0, 0, 0, 0, 0, 0, 0, 0, 0, 0, 0, 0, 
0, 0, 0, 0, 0, 0, 30, 30,
30, 0, 0, 0, 0, 0, 0, 0, 0, 0, 0, 0, 0, 0, 0, 0, 
0, 0, 0, 0, 0, 0, 0, 0, 0, 0, 0, 0, 0, 0, 0, 0, 
0, 0, 0, 0, 0, 0, 0, 30,
30, 0, 0, 0, 0, 0, 0, 0, 0, 0, 0, 0, 0, 0, 0, 0, 
0, 0, 0, 0, 0, 0, 0, 0, 0, 0, 0, 0, 0, 0, 0, 0, 
0, 0, 0, 0, 0, 0, 0, 30,
30, 0, 0, 0, 0, 0, 0, 0, 0, 0, 0, 0, 0, 0, 0, 0, 
0, 0, 0, 0, 0, 0, 0, 0, 0, 0, 0, 0, 0, 0, 0, 0, 
0, 0, 0, 0, 0, 30, 30, 30,
30, 0, 0, 0, 0, 0, 0, 0, 0, 0, 0, 0, 0, 0, 0, 0, 
0, 0, 0, 0, 0, 0, 0, 0, 0, 0, 28, 28, 28, 0, 0, 0, 
0, 0, 0, 0, 0, 0, 0, 30,
30, 0, 0, 0, 0, 0, 30, 0, 71, 0, 0, 39, 0, 71, 0, 0, 
28, 28, 28, 0, 0, 71, 0, 39, 71, 0, 0, 0, 0, 0, 0, 0, 
0, 0, 0, 0, 0, 0, 0, 30,
30, 0, 0, 0, 0, 30, 30, 0, 0, 28, 28, 28, 28, 0, 0, 0, 
0, 0, 0, 0, 0, 0, 28, 28, 0, 0, 0, 0, 0, 0, 0, 0, 
0, 0, 0, 30, 30, 30, 30, 30,
30, 0, 0, 0, 30, 30, 30, 0, 0, 0, 0, 0, 0, 0, 0, 0, 
0, 0, 0, 0, 0, 0, 0, 0, 0, 0, 0, 0, 0, 0, 0, 0, 
0, 0, 0, 0, 0, 0, 10, 30,
30, 27, 0, 30, 30, 30, 30, 18, 18, 18, 18, 18, 18, 18, 18, 18, 
18, 18, 18, 18, 18, 18, 18, 18, 18, 18, 18, 18, 18, 18, 18, 18, 
18, 30, 30, 30, 30, 30, 30, 30,
30, 30, 30, 30, 30, 30, 30, 30, 30, 30, 30, 30, 30, 30, 30, 30, 
30, 30, 30, 30, 30, 30, 30, 30, 30, 30, 30, 30, 30, 30, 30, 30, 
30, 30, 30, 30, 30, 30, 30, 30